 转生成为雷电将军 然后天下无敌  =>  拜托了我的狐仙宫司   哈玛瓦兰战记 前言   哈玛瓦兰战记 一   珍说澄研真影打 卷一  
 拜托了我的狐仙宫司  =>  鹮巷物语 三   珍说澄研真影打 卷一   转生成为雷电将军 然后天下无敌   鹮巷物语 一  
 沉秋拾剑录 一  =>  沉秋拾剑录 二   沉秋拾剑录 五   鹮巷物语 序   野猪公主 卷六  
 沉秋拾剑录 二  =>  沉秋拾剑录 一   少女薇拉的忧郁 卷七   转生成为雷电将军 然后天下无敌   拜托了我的狐仙宫司  
 沉秋拾剑录 三  =>  沉秋拾剑录 六   沉秋拾剑录 五   珍说澄研真影打 卷一   珊瑚宫记  
 沉秋拾剑录 四  =>  沉秋拾剑录 五   亡国的美奈姬 卷二   亡国的美奈姬 卷三   新六狐传 四  
 沉秋拾剑录 五  =>  沉秋拾剑录 一   沉秋拾剑录 三   沉秋拾剑录 四   沉秋拾剑录 六  
 沉秋拾剑录 六  =>  沉秋拾剑录 三   沉秋拾剑录 五   绝云记闻 山灵   少女薇拉的忧郁 卷二  
 鹮巷物语 序  =>  鹮巷物语 五   蒲公英海的狐狸 卷十   沉秋拾剑录 一   鹮巷物语 一  
 鹮巷物语 一  =>  鹮巷物语 二   鹮巷物语 三   鹮巷物语 四   拜托了我的狐仙宫司  
 鹮巷物语 二  =>  鹮巷物语 一   拜托了我的狐仙宫司   鹮巷物语 三   珍说澄研真影打 卷一  
 鹮巷物语 三  =>  拜托了我的狐仙宫司   鹮巷物语 一   鹮巷物语 四   鹮巷物语 序  
 鹮巷物语 四  =>  鹮巷物语 一   鹮巷物语 三   鹮巷物语 序   新六狐传 三  
 鹮巷物语 五  =>  鹮巷物语 序   蒲公英海的狐狸 卷十   哈玛瓦兰战记 前言   珍说澄研真影打 卷一  
 菲谢尔皇女夜谭 第零卷  =>  亡国的美奈姬 卷五   亡国的美奈姬 卷六   哈玛瓦兰战记 前言   荒山孤剑录   三  
 亡国的美奈姬 卷一  =>  亡国的美奈姬 卷二   亡国的美奈姬 卷三   亡国的美奈姬 卷四   亡国的美奈姬 卷五  
 亡国的美奈姬 卷二  =>  亡国的美奈姬 卷三   亡国的美奈姬 卷五   亡国的美奈姬 卷六   沉秋拾剑录 四  
 亡国的美奈姬 卷三  =>  亡国的美奈姬 卷二   亡国的美奈姬 卷四   亡国的美奈姬 卷五   亡国的美奈姬 卷六  
 亡国的美奈姬 卷四  =>  亡国的美奈姬 卷三   亡国的美奈姬 卷一   亡国的美奈姬 卷二   亡国的美奈姬 卷五  
 亡国的美奈姬 卷五  =>  亡国的美奈姬 卷二   亡国的美奈姬 卷三   亡国的美奈姬 卷六   野猪公主 卷五  
 亡国的美奈姬 卷六  =>  亡国的美奈姬 卷五   亡国的美奈姬 卷二   亡国的美奈姬 卷三   菲谢尔皇女夜谭 第零卷  
 哈玛瓦兰战记 前言  =>  转生成为雷电将军 然后天下无敌   鹮巷物语 序   鹮巷物语 五   菲谢尔皇女夜谭 第零卷  
 哈玛瓦兰战记 一  =>  转生成为雷电将军 然后天下无敌   哈玛瓦兰战记 二   谁人的日志 瑶光滩   碎梦奇珍 琉璃  
 哈玛瓦兰战记 二  =>  哈玛瓦兰战记 一   神霄折戟录 第六卷   转生成为雷电将军 然后天下无敌   拜托了我的狐仙宫司  
 珍说澄研真影打 卷一  =>  拜托了我的狐仙宫司   珊瑚宫记   转生成为雷电将军 然后天下无敌   沉秋拾剑录 三  
 常世国龙蛇传  =>  深海龙蜥实验记录   日月前事   白夜国地理水文考    东王 史辩  
 日月前事  =>  亡国的美奈姬 卷一   常世国龙蛇传   野猪公主 卷一   侠客记 山叟  
 白夜国地理水文考  =>  常世国龙蛇传   光昼影底集   转生成为雷电将军 然后天下无敌   拜托了我的狐仙宫司  
 深海龙蜥实验记录  =>  常世国龙蛇传   光昼影底集   巫女曚云小传    东王 史辩  
 光昼影底集  =>  白夜国地理水文考   深海龙蜥实验记录   巫女曚云小传    东王 史辩  
 鬼武道  =>  荒山孤剑录   一   荒山孤剑录   四   转生成为雷电将军 然后天下无敌   拜托了我的狐仙宫司  
 巫女曚云小传  =>   东王 史辩   珊瑚宫民间信仰初勘   珊瑚宫记   深海龙蜥实验记录  
  东王 史辩  =>  巫女曚云小传   珊瑚宫民间信仰初勘   珊瑚宫记   常世国龙蛇传  
 珊瑚宫民间信仰初勘  =>  巫女曚云小传   珊瑚宫记    东王 史辩   深海龙蜥实验记录  
 珊瑚宫记  =>  珊瑚宫民间信仰初勘   珍说澄研真影打 卷一   巫女曚云小传    东王 史辩  
 新六狐传 一  =>  神霄折戟录 第六卷   转生成为雷电将军 然后天下无敌   拜托了我的狐仙宫司   沉秋拾剑录 一  
 新六狐传 二  =>  新六狐传 四   新六狐传 三   新六狐传 五   新六狐传 六  
 新六狐传 三  =>  新六狐传 五   新六狐传 二   新六狐传 四   侠客记 留尘  
 新六狐传 四  =>  新六狐传 五   新六狐传 二   新六狐传 三   沉秋拾剑录 四  
 新六狐传 五  =>  新六狐传 四   新六狐传 三   新六狐传 二   鹮巷物语 序  
 新六狐传 六  =>  新六狐传 二   拜托了我的狐仙宫司   鹮巷物语 三   新六狐传 四  
 连心珠 卷一  =>  连心珠 卷三   连心珠 卷二   连心珠 卷四   连心珠 卷五  
 连心珠 卷二  =>  连心珠 卷一   连心珠 卷三   连心珠 卷四   连心珠 卷五  
 连心珠 卷三  =>  连心珠 卷一   连心珠 卷二   连心珠 卷四   连心珠 卷五  
 连心珠 卷四  =>  连心珠 卷三   连心珠 卷一   连心珠 卷五   连心珠 卷二  
 连心珠 卷五  =>  连心珠 卷三   连心珠 卷四   连心珠 卷一   连心珠 卷二  
 古老的考察日志 其之一  =>  古老的考察日志 其之二   古老的考察日志 其之三   冒险家罗尔德的日志 龙脊雪山   山与海之书  
 古老的考察日志 其之二  =>  古老的考察日志 其之一   古老的考察日志 其之三   冒险家罗尔德的日志 青墟浦   犬又二分之一   一  
 古老的考察日志 其之三  =>  古老的考察日志 其之二   古老的考察日志 其之一   冒险家罗尔德的日志 地中之盐   鹮巷物语 序  
 山与海之书  =>  冒险家罗尔德的日志 鹤观   古老的考察日志 其之一   冒险家罗尔德的日志 绝云间 奥藏天池   冒险家罗尔德的日志 绝云间 庆云顶  
 骑士团指导手册   第五版  =>  林间风拾遗 龙之书   古老的考察日志 其之三   提瓦特游览指南 蒙德篇   侍从骑士之歌 上篇  
 残破的笔记  =>  丘丘人习俗考察 卷一   转生成为雷电将军 然后天下无敌   拜托了我的狐仙宫司   沉秋拾剑录 一  
 帝君尘游记   一  =>  帝君尘游记   四   帝君尘游记   三   石书辑录 卷一   玑衡经  
 帝君尘游记   二  =>  帝君尘游记   一   帝君尘游记   三   竹林月夜   二   竹林月夜   三  
 帝君尘游记   三  =>  帝君尘游记   一   石书辑录 卷一   玑衡经    东王 史辩  
 帝君尘游记   四  =>  帝君尘游记   一   鹮巷物语 序   鹮巷物语 一   鹮巷物语 三  
 醉客轶事      =>  醉客轶事   二   醉客轶事   三   醉客轶事   四   野猪公主 卷一  
 醉客轶事   二  =>  醉客轶事   四   醉客轶事       醉客轶事   三   清泉之心 三  
 醉客轶事   三  =>  醉客轶事       醉客轶事   二   醉客轶事   四   鹮巷物语 二  
 醉客轶事   四  =>  醉客轶事   二   醉客轶事       醉客轶事   三   清泉之心 三  
 竹林月夜   一  =>  竹林月夜   二   竹林月夜   三   竹林月夜   四   冒险家罗尔德的日志 轻策庄  
 竹林月夜   二  =>  竹林月夜   一   竹林月夜   三   竹林月夜   四   清泉之心 一  
 竹林月夜   三  =>  竹林月夜   二   竹林月夜   四   竹林月夜   一   清泉之心 四  
 竹林月夜   四  =>  竹林月夜   二   竹林月夜   三   竹林月夜   一    东王 史辩  
 浮浪记   潮起  =>  浮浪记   狂涛   浮浪记   潮息   鹮巷物语 二   巫女曚云小传  
 浮浪记   狂涛  =>  浮浪记   潮起   浮浪记   潮息   巫女曚云小传   转生成为雷电将军 然后天下无敌  
 浮浪记   潮息  =>  浮浪记   潮起   浮浪记   狂涛   巫女曚云小传   转生成为雷电将军 然后天下无敌  
 犬又二分之一   一  =>  犬又二分之一   六   犬又二分之一  七   犬又二分之一  九   犬又二分之一  十一  
 犬又二分之一   二  =>  鹮巷物语 二   醉客轶事   三   浮浪记   潮起   犬又二分之一   一  
 犬又二分之一   三  =>  犬又二分之一   四   犬又二分之一   一   犬又二分之一   二   犬又二分之一   五  
 犬又二分之一   四  =>  犬又二分之一   三   亡国的美奈姬 卷五   犬又二分之一   一   犬又二分之一   二  
 犬又二分之一   五  =>  犬又二分之一   六   犬又二分之一  八   犬又二分之一  十一   犬又二分之一  七  
 犬又二分之一   六  =>  犬又二分之一   五   犬又二分之一  七   犬又二分之一  十一   犬又二分之一   一  
 犬又二分之一  七  =>  犬又二分之一  八   犬又二分之一  十一   犬又二分之一   六   犬又二分之一   五  
 犬又二分之一  八  =>  犬又二分之一  七   犬又二分之一  十一   犬又二分之一   五   犬又二分之一  十  
 犬又二分之一  九  =>  犬又二分之一  七   犬又二分之一  十一   犬又二分之一   一   犬又二分之一  八  
 犬又二分之一  十  =>  犬又二分之一  八   犬又二分之一   五   犬又二分之一  七   犬又二分之一  十一  
 犬又二分之一  十一  =>  犬又二分之一  七   犬又二分之一  八   犬又二分之一   五   犬又二分之一   六  
 荒山孤剑录   一  =>  荒山孤剑录   四   鬼武道   荒山孤剑录   二   荒山孤剑录   三  
 荒山孤剑录   二  =>  荒山孤剑录   三   荒山孤剑录   四   荒山孤剑录   一   蒲公英海的狐狸 卷三  
 荒山孤剑录   三  =>  荒山孤剑录   二   荒山孤剑录   四   丘丘人习俗考察 卷二   菲谢尔皇女夜谭 第零卷  
 荒山孤剑录   四  =>  荒山孤剑录   二   荒山孤剑录   三   荒山孤剑录   一   鬼武道  
 清泉之心 一  =>  清泉之心 二   清泉之心 四   清泉之心 三   竹林月夜   二  
 清泉之心 二  =>  清泉之心 一   清泉之心 三   清泉之心 四   竹林月夜   二  
 清泉之心 三  =>  清泉之心 一   清泉之心 二   清泉之心 四    东王 史辩  
 清泉之心 四  =>  清泉之心 一   清泉之心 二   清泉之心 三   竹林月夜   三  
 冒险家罗尔德的日志 地中之盐  =>  古老的考察日志 其之三   冒险家罗尔德的日志 轻策庄   冒险家罗尔德的日志 青墟浦   鹮巷物语 序  
 冒险家罗尔德的日志 轻策庄  =>  竹林月夜   一   冒险家罗尔德的日志 地中之盐   给东东的信   璃月风土志 绣球  
 冒险家罗尔德的日志 绝云间 奥藏天池  =>  冒险家罗尔德的日志 绝云间 庆云顶   古老的考察日志 其之二   古老的考察日志 其之三   山与海之书  
 冒险家罗尔德的日志 渌华池  =>  犬又二分之一  九   清泉之心 二   清泉之心 四   冒险家罗尔德的日志 瑶光滩  
 冒险家罗尔德的日志 瑶光滩  =>  竹林月夜   二   冒险家罗尔德的日志 绝云间 奥藏天池   冒险家罗尔德的日志 渌华池   冒险家罗尔德的日志 鹤观  
 冒险家罗尔德的日志 孤云阁  =>  冒险家罗尔德的日志 青墟浦   古老的考察日志 其之二   古老的考察日志 其之三   冒险家罗尔德的日志 地中之盐  
 冒险家罗尔德的日志 绝云间 庆云顶  =>  冒险家罗尔德的日志 绝云间 奥藏天池   冒险家罗尔德的日志 青墟浦   古老的考察日志 其之二   古老的考察日志 其之三  
 冒险家罗尔德的日志 青墟浦  =>  古老的考察日志 其之二   冒险家罗尔德的日志 地中之盐   冒险家罗尔德的日志 孤云阁   冒险家罗尔德的日志 绝云间 庆云顶  
 冒险家罗尔德的日志 龙脊雪山  =>  古老的考察日志 其之一   野猪公主 卷六   古老的考察日志 其之二   山与海之书  
 冒险家罗尔德的日志 离岛  =>  鹮巷物语 序   鹮巷物语 五   哈玛瓦兰战记 前言   珍说澄研真影打 卷一  
 冒险家罗尔德的日志 鹤观  =>  山与海之书   深海龙蜥实验记录   光昼影底集   冒险家罗尔德的日志 绝云间 奥藏天池  
 野猪公主 卷一  =>  野猪公主 卷二   野猪公主 卷四   野猪公主 卷五   野猪公主 卷七  
 野猪公主 卷二  =>  野猪公主 卷一   野猪公主 卷四   野猪公主 卷三   野猪公主 卷五  
 野猪公主 卷三  =>  野猪公主 卷四   野猪公主 卷七   野猪公主 卷一   野猪公主 卷二  
 野猪公主 卷四  =>  野猪公主 卷三   野猪公主 卷一   野猪公主 卷二   野猪公主 卷七  
 野猪公主 卷五  =>  野猪公主 卷七   亡国的美奈姬 卷五   野猪公主 卷一   野猪公主 卷六  
 野猪公主 卷六  =>  冒险家罗尔德的日志 龙脊雪山   野猪公主 卷五   野猪公主 卷七   沉秋拾剑录 一  
 野猪公主 卷七  =>  野猪公主 卷五   野猪公主 卷一   野猪公主 卷三   野猪公主 卷四  
 蒲公英海的狐狸 卷一  =>  蒲公英海的狐狸 卷十一   蒲公英海的狐狸 卷七   蒲公英海的狐狸 卷十   蒲公英海的狐狸 卷三  
 蒲公英海的狐狸 卷二  =>  蒲公英海的狐狸 卷三   蒲公英海的狐狸 卷五   鹮巷物语 序   鹮巷物语 五  
 蒲公英海的狐狸 卷三  =>  蒲公英海的狐狸 卷十   蒲公英海的狐狸 卷一   蒲公英海的狐狸 卷五   蒲公英海的狐狸 卷十一  
 蒲公英海的狐狸 卷四  =>  蒲公英海的狐狸 卷一   蒲公英海的狐狸 卷十   蒲公英海的狐狸 卷三   蒲公英海的狐狸 卷五  
 蒲公英海的狐狸 卷五  =>  蒲公英海的狐狸 卷七   蒲公英海的狐狸 卷十   蒲公英海的狐狸 卷一   蒲公英海的狐狸 卷三  
 蒲公英海的狐狸 卷六  =>  蒲公英海的狐狸 卷七   蒲公英海的狐狸 卷五   蒲公英海的狐狸 卷一   蒲公英海的狐狸 卷四  
 蒲公英海的狐狸 卷七  =>  蒲公英海的狐狸 卷一   蒲公英海的狐狸 卷十一   蒲公英海的狐狸 卷五   蒲公英海的狐狸 卷六  
 蒲公英海的狐狸 卷八  =>  蒲公英海的狐狸 卷七   蒲公英海的狐狸 卷九   蒲公英海的狐狸 卷五   蒲公英海的狐狸 卷十  
 蒲公英海的狐狸 卷九  =>  蒲公英海的狐狸 卷七   蒲公英海的狐狸 卷八   蒲公英海的狐狸 卷五   蒲公英海的狐狸 卷十  
 蒲公英海的狐狸 卷十  =>  蒲公英海的狐狸 卷三   蒲公英海的狐狸 卷一   蒲公英海的狐狸 卷五   蒲公英海的狐狸 卷十一  
 蒲公英海的狐狸 卷十一  =>  蒲公英海的狐狸 卷一   蒲公英海的狐狸 卷七   蒲公英海的狐狸 卷十   蒲公英海的狐狸 卷三  
 给东东的信  =>  竹林月夜   二   冒险家罗尔德的日志 轻策庄   蒲公英海的狐狸 卷一   蒲公英海的狐狸 卷二  
 谁人的日志 瑶光滩  =>  转生成为雷电将军 然后天下无敌   鹮巷物语 一   哈玛瓦兰战记 一   提瓦特游览指南 蒙德篇  
 谁人的日志 归离原  =>  侠客记 留尘   提瓦特大陆游览指南 璃月篇   石书辑录 卷一   转生成为雷电将军 然后天下无敌  
 谁人的日志 绝云间  =>  亡国的美奈姬 卷五   犬又二分之一   四   冒险家罗尔德的日志 绝云间 庆云顶   侠客记 山叟  
 谁人的日志 璃月港  =>  给东东的信   谁人的日志 刃连岛   转生成为雷电将军 然后天下无敌   拜托了我的狐仙宫司  
 谁人的日志 刃连岛  =>  拜托了我的狐仙宫司   给东东的信   谁人的日志 璃月港   转生成为雷电将军 然后天下无敌  
 璃月风土志 绣球  =>  石书辑录 卷一   沉秋拾剑录 四   亡国的美奈姬 卷二   亡国的美奈姬 卷三  
 璃月风土志 迎神  =>  竹林月夜   一   侠客记 山叟   提瓦特大陆游览指南 璃月篇   石书辑录 卷一  
 璃月风土志 霓裳花  =>  连心珠 卷二   竹林月夜   二   冒险家罗尔德的日志 轻策庄   冒险家罗尔德的日志 绝云间 奥藏天池  
 侠客记 山叟  =>  亡国的美奈姬 卷一   日月前事   犬又二分之一   五   冒险家罗尔德的日志 绝云间 庆云顶  
 侠客记 留尘  =>  新六狐传 三   沉秋拾剑录 三   亡国的美奈姬 卷一   野猪公主 卷二  
 提瓦特游览指南 蒙德篇  =>  古老的考察日志 其之一   古老的考察日志 其之二   古老的考察日志 其之三   骑士团指导手册   第五版  
 提瓦特大陆游览指南 璃月篇  =>  石书辑录 卷一   竹林月夜   一   冒险家罗尔德的日志 轻策庄   冒险家罗尔德的日志 绝云间 庆云顶  
 提瓦特大陆游览指南 稻妻篇  =>  鹮巷物语 序   鹮巷物语 五   哈玛瓦兰战记 前言   珍说澄研真影打 卷一  
 丘丘人习俗考察 卷一  =>  丘丘人习俗考察 卷二   丘丘人习俗考察 卷三   丘丘人习俗考察 卷四   丘丘人诗歌选 下卷  
 丘丘人习俗考察 卷二  =>  丘丘人习俗考察 卷四   丘丘人习俗考察 卷一   丘丘人习俗考察 卷三   丘丘人诗歌选 下卷  
 丘丘人习俗考察 卷三  =>  丘丘人习俗考察 卷一   丘丘人习俗考察 卷二   丘丘人习俗考察 卷四   丘丘人诗歌选 上卷  
 丘丘人习俗考察 卷四  =>  丘丘人习俗考察 卷二   丘丘人习俗考察 卷一   丘丘人习俗考察 卷三   丘丘人诗歌选 下卷  
 丘丘人诗歌选 上卷  =>  丘丘人习俗考察 卷一   丘丘人习俗考察 卷二   丘丘人习俗考察 卷三   丘丘人习俗考察 卷四  
 丘丘人诗歌选 下卷  =>  丘丘人习俗考察 卷一   丘丘人习俗考察 卷二   丘丘人习俗考察 卷四   丘丘人习俗考察 卷三  
 神霄折戟录 第一卷  =>  神霄折戟录 第三卷   神霄折戟录 第二卷   神霄折戟录 第四卷   神霄折戟录 第五卷  
 神霄折戟录 第二卷  =>  神霄折戟录 第四卷   神霄折戟录 第三卷   神霄折戟录 第一卷   神霄折戟录 第五卷  
 神霄折戟录 第三卷  =>  神霄折戟录 第一卷   神霄折戟录 第二卷   神霄折戟录 第四卷   神霄折戟录 第五卷  
 神霄折戟录 第四卷  =>  神霄折戟录 第二卷   神霄折戟录 第一卷   神霄折戟录 第三卷   亡国的美奈姬 卷一  
 神霄折戟录 第五卷  =>  神霄折戟录 第二卷   神霄折戟录 第一卷   神霄折戟录 第三卷   神霄折戟录 第四卷  
 神霄折戟录 第六卷  =>  拜托了我的狐仙宫司   菲谢尔皇女夜谭 第零卷   哈玛瓦兰战记 二   常世国龙蛇传  
 碎梦奇珍 蓝宝石  =>  碎梦奇珍 月光   碎梦奇珍 石心   帝君尘游记   一   犬又二分之一   一  
 碎梦奇珍 月光  =>  清泉之心 二   碎梦奇珍 蓝宝石    东王 史辩   帝君尘游记   一  
 碎梦奇珍 石心  =>  碎梦奇珍 蓝宝石   帝君尘游记   一   竹林月夜   二   碎梦奇珍 月光  
 碎梦奇珍 琉璃  =>  转生成为雷电将军 然后天下无敌   哈玛瓦兰战记 一   谁人的日志 瑶光滩   碎梦奇珍 月光  
 风 勇气和翅膀  =>  蒲公英海的狐狸 卷七   温妮莎传奇 下篇   与神性同行 序言   转生成为雷电将军 然后天下无敌  
 绝云记闻 石兽  =>  绝云记闻 山灵   绝云记闻 玉遁   石书辑录 卷一   帝君尘游记   一  
 绝云记闻 海神宫  =>  犬又二分之一   一   鹮巷物语 二   醉客轶事   三   浮浪记   潮起  
 绝云记闻 无妄  =>  哈玛瓦兰战记 一   犬又二分之一   五   绝云记闻 麒麟   转生成为雷电将军 然后天下无敌  
 绝云记闻 山灵  =>  绝云记闻 石兽   绝云记闻 玉遁   沉秋拾剑录 六   鹮巷物语 四  
 绝云记闻 麒麟  =>  鹮巷物语 序   鹮巷物语 一   鹮巷物语 三   鹮巷物语 四  
 绝云记闻 玉遁  =>  绝云记闻 石兽   绝云记闻 山灵   帝君尘游记   四   醉客轶事   三  
 石书辑录 卷一  =>  帝君尘游记   一   帝君尘游记   三   璃月风土志 绣球   提瓦特大陆游览指南 璃月篇  
 玑衡经  =>  帝君尘游记   一   帝君尘游记   三   石书辑录 卷一   帝君尘游记   二  
 侍从骑士之歌 上篇  =>  常世国龙蛇传   骑士团指导手册   第五版   侍从骑士之歌   林间风拾遗 龙之书  
 侍从骑士之歌  =>  骑士团指导手册   第五版   犬又二分之一   一   清泉之心 二   丘丘人诗歌选 下卷  
 少女薇拉的忧郁 卷一  =>  清泉之心 一   蒲公英海的狐狸 卷七   蒲公英海的狐狸 卷八   少女薇拉的忧郁 卷六  
 少女薇拉的忧郁 卷二  =>  少女薇拉的忧郁 卷六   少女薇拉的忧郁 卷八   少女薇拉的忧郁 卷十   少女薇拉的忧郁 卷三  
 少女薇拉的忧郁 卷三  =>  少女薇拉的忧郁 卷七   少女薇拉的忧郁 卷八   少女薇拉的忧郁 卷六   少女薇拉的忧郁 卷二  
 少女薇拉的忧郁 卷四  =>  少女薇拉的忧郁 卷二   少女薇拉的忧郁 卷三   少女薇拉的忧郁 卷六   少女薇拉的忧郁 卷八  
 少女薇拉的忧郁 卷五  =>  少女薇拉的忧郁 卷六   少女薇拉的忧郁 卷七   少女薇拉的忧郁 卷二   少女薇拉的忧郁 卷三  
 少女薇拉的忧郁 卷六  =>  少女薇拉的忧郁 卷七   少女薇拉的忧郁 卷二   少女薇拉的忧郁 卷三   少女薇拉的忧郁 卷五  
 少女薇拉的忧郁 卷七  =>  少女薇拉的忧郁 卷三   少女薇拉的忧郁 卷六   少女薇拉的忧郁 卷八   少女薇拉的忧郁 卷五  
 少女薇拉的忧郁 卷八  =>  少女薇拉的忧郁 卷三   少女薇拉的忧郁 卷七   少女薇拉的忧郁 卷二   少女薇拉的忧郁 卷六  
 少女薇拉的忧郁 卷九  =>  少女薇拉的忧郁 卷十   少女薇拉的忧郁 卷二   少女薇拉的忧郁 卷三   少女薇拉的忧郁 卷五  
 少女薇拉的忧郁 卷十  =>  少女薇拉的忧郁 卷九   少女薇拉的忧郁 卷二   少女薇拉的忧郁 卷六   少女薇拉的忧郁 卷三  
 林间风 故事拔萃  =>  林间风拾遗 龙之书   古老的考察日志 其之三   骑士团指导手册   第五版   荒山孤剑录   三  
 蒙德高塔 第一卷  =>  犬又二分之一   一   鹮巷物语 二   醉客轶事   三   浮浪记   潮起  
 林间风拾遗 龙之书  =>  骑士团指导手册   第五版   林间风 故事拔萃   古老的考察日志 其之三   醉客轶事      
 白之公主与六侏儒 卷一  =>  沉秋拾剑录 一   鹮巷物语 序   醉客轶事       清泉之心 二  
 温妮莎传奇 上篇  =>  温妮莎传奇 下篇   古老的考察日志 其之三   骑士团指导手册   第五版   提瓦特游览指南 蒙德篇  
 温妮莎传奇 下篇  =>  温妮莎传奇 上篇   与神性同行 序言   鹮巷物语 二   醉客轶事   三  
 与神性同行 序言  =>  温妮莎传奇 下篇   深海龙蜥实验记录   醉客轶事   四   蒲公英海的狐狸 卷七  
